111111111111111111111111
100000000100010000000001
110011100102010011000001
100000000100010000000001
100000000111110010010001
111110100000001000001001
100000001010100000000001
100000000101011111000001
100000000010000000030001
101111100010000030000001
100000100000000000000001
100000100001111000000001
100001111111001000000001
100001000001001111111001
100001000001000000100001
101111000001000000111001
100000000111111100000001
100000001000000100000001
100111110000000100000001
101100000010100111100001
101100000100000000100001
100000000100100300100001
100001000000100000000001
111111111111111111111111