333333333333333333333333
355335555355535555535553
355553555352535535355553
355555355355535535555553
355555535333335355555553
335355553555553555555553
355555553535355555555553
355555555353553535555553
355555533335553333335553
353333355533355535555553
355555355555555555555553
355555355555553555555553
355553333333333555555553
355553555555533555333553
355553555553555555355553
353333555333555555333553
355555555355553355555553
355555553553333355555553
355333333355555355555553
353355555533535333355553
353355555355355555355553
355555533353355355355553
355553555555355555555553
333333333333333333333333